0 0 0 1 0 0 0 0 0 0 0 1 0 0 0 1 9 0 0 1 0 0 0 0 
0 3 0 1 0 1 0 12 1 1 0 1 0 1 0 1 0 1 0 1 5 1 0 0 
0 4 0 1 0 0 0 1 0 1 0 1 0 1 0 1 0 1 0 1 1 0 0 0
1 0 0 8 1 1 0 0 0 1 0 0 0 1 0 0 0 1 0 0 0 0 1 0 
0 1 0 0 0 0 0 1 0 0 0 1 1 1 0 1 0 1 0 1 0 0 1 0 
0 1 0 0 0 1 1 1 0 0 0 0 0 0 0 1 0 0 0 0 1 1 1 0 
0 0 0 0 1 0 0 1 1 1 1 1 0 1 0 0 0 1 0 0 1 0 0 0 
0 0 1 0 0 0 0 0 0 0 0 1 0 1 0 1 1 1 0 1 0 0 0 1 
0 0 10 1 0 1 0 0 1 0 0 1 0 1 0 1 0 0 0 1 0 0 0 0 
0 0 1 0 0 1 0 0 13 1 0 1 0 0 0 0 0 1 1 1 1 0 11 0 
1 1 0 0 7 0 1 0 0 0 0 1 1 1 0 0 0 0 0 0 1 0 1 0 
0 0 0 0 0 0 0 1 1 0 0 0 0 0 0 1 0 0 1 0 0 0 1 6